Pair the Penguins
Click on a penguin. Then use the arrow keys to move it
1
4 3 down
#########
#.......#
#...r...#
#.......#
#.......#
#.......#
#...r...#
#.......#
#########